X	X	X	X	X	X	X	X	X	X	X	X	X	X	X	X	X	X	X	X	X	X	X	X	X	X	X	X
X	X	X	X	X	X	X	X	X	X	X	X	X	X	X	X	X	X	X	X	X	X	X	X	X	X	X	X
X	X	X	X	X	X	X	X	X	X	X	X	X	X	X	X	X	X	X	X	X	X	X	X	X	X	X	X
X	X	X	F	F	F	F	F	F	F	F	F	F	F	F	F	F	F	F	F	F	F	F	F	F	X	X	X
X	X	X	F	X	X	X	X	X	X	X	X	X	X	X	F	X	X	X	X	X	X	X	X	F	X	X	X
X	X	X	F	X	X	X	X	X	X	X	X	X	X	X	F	X	X	X	X	X	X	X	X	F	X	X	X
X	X	X	F	X	X	F	F	F	X	F	F	F	X	F	F	F	X	F	F	F	X	X	X	F	X	X	X
X	X	X	F	X	X	F	F	F	F	F	F	F	X	F	F	F	X	F	F	F	X	X	X	F	X	X	X
X	X	X	F	X	X	F	F	F	X	F	F	F	X	F	F	F	X	F	F	F	X	X	X	F	X	X	X
X	X	X	F	X	X	X	X	X	X	X	F	X	X	X	F	X	X	X	F	X	X	X	X	F	X	X	X
X	X	X	F	X	X	F	F	F	X	X	F	X	X	X	F	X	X	X	F	X	F	F	X	F	X	X	X
X	X	X	F	F	F	F	F	F	F	F	F	F	F	F	F	F	F	F	F	F	F	F	X	F	X	X	X
X	X	X	F	X	X	F	F	F	X	X	F	X	X	X	X	X	X	X	F	X	F	F	X	F	X	X	X
X	X	X	F	X	X	X	F	X	X	X	F	X	X	X	X	X	X	X	F	X	X	X	X	F	X	X	X
X	X	X	F	X	X	F	F	F	X	F	F	F	X	F	F	F	X	F	F	F	X	X	X	F	X	X	X
X	X	X	F	X	X	F	F	F	X	F	F	F	F	F	F	F	X	F	F	F	X	X	X	F	X	X	X
X	X	X	F	X	X	F	F	F	X	F	F	F	X	F	F	F	X	F	F	F	X	X	X	F	X	X	X
X	X	X	F	X	X	X	F	X	X	X	X	X	X	X	F	X	X	X	X	X	X	X	X	F	X	X	X
X	X	X	F	X	X	F	F	F	X	X	X	X	F	F	F	F	F	X	X	F	F	F	X	F	X	X	X
X	X	X	F	X	X	F	F	F	X	X	X	X	F	F	F	F	F	X	X	F	F	F	X	F	X	X	X
X	X	X	F	X	X	X	X	X	X	X	X	X	X	X	X	X	X	X	X	X	F	X	X	F	X	X	X
X	X	X	F	F	F	F	F	F	F	F	F	F	F	F	F	F	F	F	F	F	F	F	F	F	X	X	X
X	X	X	X	X	X	F	X	X	X	X	X	X	X	F	X	X	X	X	X	X	F	X	X	X	X	X	X
X	X	X	X	X	X	F	X	X	X	X	X	X	X	F	X	X	X	X	X	X	F	X	X	X	X	X	X
X	X	X	X	F	F	F	F	F	X	X	X	F	F	F	F	F	X	X	F	F	F	F	F	X	X	X	X
X	X	X	X	F	F	F	F	F	X	X	X	F	F	F	F	F	X	X	F	F	F	F	F	X	X	X	X
X	X	X	X	F	F	F	F	F	X	X	X	F	F	F	F	F	X	X	F	F	F	F	F	X	X	X	X
X	X	X	X	X	X	X	X	X	X	X	X	X	X	X	X	X	X	X	X	X	X	X	X	X	X	X	X