X	X	X	X	X	X	X	X	X	X	X	X	X	X	X	X	X	X	X	X	X	X	X	X	X	X	X	X
X	X	P	P	P	P	P	X	X	X	X	X	P	P	P	X	X	X	X	X	X	X	X	X	X	X	X	X
X	X	P	P	P	P	P	P	P	P	X	X	P	P	P	X	X	X	P	P	P	P	X	X	X	X	X	X
X	X	P	P	P	P	P	X	X	P	X	X	P	P	P	X	X	X	X	X	X	P	X	X	X	X	X	X
X	X	X	X	P	X	X	X	X	P	X	X	X	P	X	X	X	X	X	X	X	P	X	P	P	P	P	X
X	X	X	X	P	X	X	X	X	P	P	P	P	P	P	P	P	P	P	X	X	P	P	P	P	P	P	X
X	X	X	X	P	X	X	X	X	X	X	X	X	P	X	X	X	X	P	X	X	X	X	P	P	P	P	X
X	X	P	P	P	P	P	X	X	X	X	X	X	X	X	X	X	X	P	X	X	X	X	P	P	P	P	X
X	X	P	P	P	P	P	P	P	P	P	P	P	P	P	P	P	P	P	X	X	X	X	P	P	P	P   x
X	X	P	P	P	P	P	X	X	X	X	X	X	X	X	X	X	X	X	X	X	X	X	X	X	P	X	X
X	X	X	X	P	X	X	X	X	X	X	X	X	X	P	P	P	P	P	P	P	P	X	X	X	P	X	X
X	X	X	X	P	X	X	X	X	X	X	X	X	X	P	P	P	P	P	P	P	P	X	X	X	P	X	X
X	X	X	X	P	X	X	P	P	P	P	P	X	X	P	P	P	P	P	P	P	P	X	X	X	P	X	X
X	X	P	P	P	P	P	P	P	P	P	P	P	P	P	X	X	X	P	X	X	X	X	X	X	P	X	X
X	X	X	X	X	X	X	P	P	P	P	P	X	X	X	X	X	X	P	X	X	X	X	X	X	P	X	X
X	X	X	X	P	X	X	X	X	P	X	X	X	X	X	X	P	P	P	P	P	X	X	X	X	P	X	X
X	X	X	X	P	X	X	X	X	P	X	X	X	X	X	X	P	P	P	P	P	P	P	P	P	P	X	X
X	X	X	X	P	X	X	X	X	P	P	P	P	P	X	X	P	P	P	P	P	X	X	X	X	P	X	X
X	X	P	P	P	P	X	X	X	P	X	X	X	P	X	X	X	X	P	X	X	X	X	X	X	P	X	X
X	X	P	X	X	P	X	X	X	P	X	X	X	P	X	X	X	X	P	X	X	X	X	X	X	P	X	X
X	X	P	X	X	P	X	X	P	P	P	P	P	P	P	P	P	P	P	P	P	P	P	P	P	P	X	X
X	X	P	X	X	X	X	X	X	X	X	X	X	X	X	X	X	X	P	X	X	X	X	P	X	X	X	X
X	X	P	P	P	P	P	P	X	X	P	P	P	P	P	P	P	P	P	P	P	P	X	P	X	X	X	X
X	X	P	X	X	P	P	P	X	X	P	X	X	P	X	X	X	X	P	X	X	X	X	P	X	X	X	X
X	X	P	X	X	P	P	P	X	X	P	X	X	P	X	X	X	X	P	X	X	P	P	P	P	P	X	X
X	X	P	X	X	P	P	P	P	P	P	X	P	P	P	X	X	X	P	P	P	P	P	P	P	P	X	X
X	X	X	X	X	X	X	X	X	X	X	X	P	P	P	X	X	X	X	X	X	X	X	X	X	X	X	X
X	X	X	X	X	X	X	X	X	X	X	X	X	X	X	X	X	X	X	X	X	X	X	X	X	X	X	X